11111111111111111111111111111
10001000010000010000100000001
1000001000001000001   1001001
10001000010010000011111101111
1000100001001000001   0000111
1000100000100000001  11111111
1000101001000000001    1
111111111111111111111111
