11111111111111111111111111111
10000000010000000000100000001
1000000000000000001   1001001
10000000010000000011111101111
1000100000000000001   0000111
1000100000100000001  11111111
1000000000000000001    1
111111111111111111111111
