NO imgs/t2.xpm
SO imgs/t8.xpm
WE imgs/n3.xpm
EA imgs/n2.xpm

F 192,192,192
C 0,0,255

            1111111111111111111111111
            1000000000110000000000001
            1011000001110000000000001
            1001000000000000000000001
1111111111111000011100000000000000001
1000000000110000011101111111111111111
11110111111111011100000010001
11110111111111011101010000001
11000000110101011100000000001
10000000000000001100000000001
10000000000000001101010010001
11000001110101011111011110N0111
11110111 1110101 101111010001
11111111 1111111 111111111111