1111111111
1000110001
1001000001
1000000001
1000010001
1000010001
1001100001
1100000001
1001000011
1111111111
