1111111111111111111
1000000001000000001
1000000000000000001
10000000010000000011111111111
1000100000000000001      1  1
1000100000100000001  1
1000000000000000001
1111111111111111111
