1111111111111111111111111111
1000110000000000000000000001
1001000001100000000000000111
1000000000000000000000000001
1000010001111111100000000001
1000010001100000000000000001
1001100000000000000000000001
1100000001111111111000101111
1001000011000000000000000001
1111111111111111111111111111