NO imgs/t2.xpm
SO imgs/t8.xpm
WE imgs/n3.xpm
EA imgs/n2.xpm

F 192,192,192
C 0,0,255

      1111111111111111111111111
      1000000000000000000000111
      1001000001000100000000111
      1001000000000000010000001
111111110110001000100101111111111
10000000000000000010000000111
111100S0001001001000000001001
11110000100000000110101000001
11000000110101000000000001001
10001010000100100000010001
10000100010000100001010010001
11000001110101011111011110001
11110111 1000001 111011 10101
11111111 1111111 111111 11111