11111111111111111
10000000000000111
11000000000111011
10000000000000111
11000000000111111
11111111111111111