NO imgs/w.xpm
SO imgs/redbrick.xpm
WE imgs/d.xpm
EA imgs/rw.xpm

F 139,69,19
C 100,150,255

      11111111111111111111111111
      11100000001000000000000111
      1001000001000100000000111
      1001000100000000010000001
11111111011000100010000111111111
100010000011000000010000000111
1111000100100S1010000000010011
111100001000000001101010010011
110000001101010000000000010001
10000010000100100000000010001
10000100010000100901010010001
1100000001010101111101111000111
1111011100000000101101111010011
111111111111111111111111111111
