NO imgs/t2.xpm
SO imgs/t8.xpm
WE imgs/n3.xpm
EA imgs/n2.xpm

F 192,192,192
C 0,0,255

      1111111111111111111111111
      1100000000000000000000011
      1001000001010100000000111
      1001000000000000010000001
1111111101100010001001011111111
1000000000000W000010000000111
11110001001001001000000001001
11110000100000000110101000001
11000000110101000000000001001
10001010000100100000000010001
10000100010000100001010010001
11000000010101011111011110001
11110111000000000011011110101
11111111111111111111111111111