NO imgs/w.xpm
SO imgs/redbrick.xpm
WE imgs/eagle.xpm
EA imgs/wood.xpm
F 220,100,10
C 4,152,255

1111111111111111111111111
1000010000100000000000011
1011000001000001001000111
10010000010000E00000000011
11000001011000000010000111111111
100000000011000000010111111111111
111100000000001010000000010011
111100000000000011101010010011
11000000110101011100000010001
10000000000000001100000010001
10000000000000001101010010001
1100000111010101111101111000111
11110111011110101101111010001
111111111111111111111111111111
