NO imgs/t2.xpm
SO imgs/t8.xpm
WE imgs/n3.xpm
EA imgs/n2.xpm

F 192,192,192
C 0,0,255

      1111111111111111111111111
      1100000000000000000000011
        11000001010100000000111
      1101000000000000010000001
1111111111011000100010010111111
1000000000000W000010000000111
11110001001001001000000001001
1100010000000011010100000111
11100001101010000000000011
1010101000010010000000001011
10000100010000100001010010001
11000000010101011111011110001
111101111 1000000011011110101
111111111 1111111111111111111