NO imgs/w.xpm
SO imgs/redbrick.xpm
WE imgs/eagle.xpm
EA imgs/wood.xpm
F 220,100,10
C 4,152,255

1111111111111111111111111
10S1110000000000000000011
1001000000000000000001111
10010000000000000000000011
11000001011000000010000111111111
100000000011000000010111111111111
111100000000001010000000010011
111100000000000011101010010011
110000001101010000000000010001
10000000000000000000000010001
10000000000000000901010010001
1100000001010101111101111000111
1111011100000000101101111010011
111111111111111111111111111111
