NO imgs/n.xpm
SO imgs/n4.xpm
WE imgs/n3.xpm
EA imgs/n2.xpm

F 192,192,192
C 100,150,255

      11111111111111111111111111
      11000000000000000000000111
      1001000001000100000000111
      1001000000000000010000001
11111111011000100010010111111111
100010000010000000010000000111
111100010010000010000000010011
111100001000000001101010010011
110000001101010S00000000010001
10000010000100100000000010001
10000100010000100001010010001
1100000001010101111101111000111
1111011100000000101101111010011
111111111111111111111111111111