NO imgs/d.xpm
SO imgs/j.xpm
WE imgs/t.xpm
EA imgs/s.xpm

F 90,90,255
C 100,150,255

11111111111111111111111111111111111111111
10000100001000000100000110000000000000001
1011001001000001001000110000100000N000001
10010001000100000100000100001000000010001
10010010001000100000000001000000001000001
10010001010000001000001000000100100010001
10010010000000100000010000000110000000001
10010001010000000010010000100001000010001
10010001000100100000010001010001000000011
10010010010000100100100001000001001001001
11111111111111111111111111111111111111111