NO imgs/q.xpm
SO imgs/redbrick.xpm
WE imgs/eagle.xpm
EA imgs/wood.xpm
F 20,50,100
C 49,100,200

11111111111111111111111111111111111111111
10000100001000000100000110000000000000001
1011001001000001001000110000000000S000001
10010000000000000100000000000000000000001
10010010000000100000000001000000000000001
10010000010000001000000000000000000000001
10010010000000100000010000000000000000001
10010000010000000010000000000000000000001
10010000000000100000000000000000000000011
10010010010000000100100000000000000000001
11111111111111111111111111111111111111111